D111795393
92AC5416AA
86C393C542
ABFAAAFFFA
AAFC6857FA
AAFFFAFFFA
C453FAFD52
953AFAFFFA
ABAAD05552
C6C4545556

0,0
9,9
EEESEEESEEESSSSSSS
